########################################
#______________________________________#
#______________________________________#
#______________________________________#
#______________________________________#
#______________________________________#
#______________________________________#
#______________________________________#
#______________________________________#
#______________________________________#
#______________________________________#
#______________________________________#
#______________________________________#
#______________________________________#
#______________________________________#
#______________________________________#
#______________________________________#
#______________________________________#
#______________________________________#
#______________________________________#
#______________________________________#
#__________________p___________________#
########################################