########################################
#______________________________________#
#______________________________________#
#______________________________________#
#_______________________________f______#
#_____________________________####_____#
#____________________####______________#
#______________________________________#
#____###______###______________________#
#______#______#________________________#
#____c_#______#________________________#
#______#_______________________________#
#______#_______________________________#
#______________________________________#
#_______________________________#______#
#_______________________________#______#
#_________####__________________#______#
#__________________#######______#______#
#_______________________________#______#
#_______________________________#______#
#______________________________________#
#___________p__________________________#
########################################