########################################
#______________________________________#
#______________________________________#
#______________________________________#
#______________________________________#
#________________________________f_____#
#_________________________#########____#
#______________________________________#
#________________#####_________________#
#______________________________________#
#_______####______________________c____#
#______________________________________#
#_______________________________#####__#
#______________________________________#
#####__________________________________#
#______________________________________#
#________####__________________________#
#_________________###__________________#
#______________________________________#
#_________________________####_________#
#______________________________________#
#_p____________________________________#
########################################