########################################
#______________________________________#
#______________________________________#
#______________________________________#
#_____________##____##____#____________#
#_______s___ssssssssssssssssssss#____p_#
#___####################################
#______________________________________#
#______________________________________#
#_____ss__ss_______#sss_________#sss___#
####################################___#
#______________________________________#
#______________________________________#
#______________________________________#
#______________________________________#
#______________________________________#
#______________________________________#
#_____________________#________________#
#_____________###______________________#
#_f____#___________________#___________#
####____________________________###____#
#ssssssssssssssssssssssssssssssssssssss#
########################################