########################################
#______________________________________#
#______________________________________#
#______________________________________#
#_________________________________f____#
#______________________________#####___#
#____________######________s___________#
#_______________________####___________#
#_____###______________________________#
#_____#________________________________#
#_____#________________________________#
#______________________________________#
#______________________________________#
#______________________________________#
#ss_________________######_____________#
######______________#__________________#
#_______________##__#______________ssss#
#_________##________#_________##########
#c__________________#__________________#
#___________________######_____________#
#___###_____________#__________________#
#sssssssssssssssssss#_____________p____#
########################################